"floor","room","name"
3,"3G-A","미나"
3,"3G-B","나연"
3,"3G-C","다현"
4,"4G-A","정연"
4,"4G-B","지효"
4,"4G-C","채연"
5,"5G-A","모모"
5,"5G-B","쯔위"
5,"5G-C","사나"
